SO cubfile/1.xpm
WE cubfile/2.xpm
NO cubfile/3.xpm
EA cubfile/4.xpm
S cubfile/sprite.xpm
R 600 480
C 137, 189, 222
F 100, 100, 100

11111
10201
10N01
10001
11111
