SO 1.xpm
WE 2.xpm
NO 3.xpm
EA 4.xpm
S so_hinami.xpm
R 1000 480
C 137, 189, 222
F 100, 100, 100

11111
10001
10S01
11111
